20
15
+-+-+----+---------+
| +-+              |
|    M + +-------+ |
+------+ |       | |
|      | |  +-++ | |
| +-+  | |     | | |
| | +  + +--+  | | |
| |      |  |  | | |
| +-+----+--+  | | |
| |         |  | + +
| +---------+  |   |
|              |   |
+-+-------- ---+ + +
| |            | | |
+-+------------+P+-+
