31
13
+M-+--+--+--+--+--+--+--+--+--+
|  |  |     |     |     |  |  |
+  +  +--+  +  +--+--+  +  +  +
|  |     |           |        |
+  +  +--+  +--+--+--+--+--+  +
|        |  |  |           |  |
+  +--+--+  +  +  +--+  +--+  +
|  |              |           |
+  +  +  +  +  +--+--+--+--+--+
|     |  |  |     |           |
+  +  +--+--+--+  +--+--+  +--+
|  |  |                       |
+--+--+--+--+--+--+--+--+--+P-+
